NO textures/texture1.png

SO textures/texture2.png

WE textures/texture3.png

EA textures/texture4.png


F 18,53,25

C 153,204,255

                                   111
                                   101
      1111111                      101
111111111111                  111111011
100000000011111111111111111111111100001
100000000000000000000000000000000000N01
111111111111111111111111111111100000001
100000000001                  111111111
111111111101
110000000001        111111
111111111111