NO textures/texture1.png

SO textures/texture2.png

WE textures/texture3.png

EA textures/texture4.png


F 35,35,40

C 120,150,175

11111111111111111
1000000000000E01
11111111111111111