NO textures/texture1.png

SO textures/texture2.png

WE textures/texture3.png

EA textures/texture4.png


F 18,53,25

C 153,204,255

11111111111111111
100000000000000E1
11111111111111111