NO textures/texture1.png

SO textures/texture2.png

WE textures/texture3.png

EA textures/texture4.png


F 35,35,40

C 120,150,175

                                   111
                                   101
      1111111                      101
111111111111             
100000000111111111111111111111111000001
1000000000000000000000000000000000N0001
111111111111111111111111111111100000001
100000000001                  111111111
111111111101
110000000001        111111
111111111111


