NO                      textures/wolfenstein/grey_stone.png

SO textures/wolfenstein/blue_stone.png

WE textures/wolfenstein/red_brick.png

EA textures/wolfenstein/wood.xpm

F 18,53,25

C 153,204,255

      1111111
111111111111                  111111111
100000000011111111111111111111100000001
10000000000000000000000000000000000S001
111111111111111111111111111111100000001
100000000001                  111111111
111111111101
110000000001        111111
11111111111